000000000000011000000000000000000!
000000000000011000000000000000000!
000000000000011000000000000000000!
000000000000011000000000000000000!
000000000000011000000000000000000!
000000000000011000000000000000000!
110000000000011000000000000000000!
111111111111111111111111110000000!
111111111111111111111111111111000!
111111110011100111111111111111111!
111111110011100111111111111111111!
111111111111111111111111111111000!
111111111111111111111111110000000!
110000000000011000000000000000000!
000000000000011000000000000000000!
000000000000011000000000000000000!
000000000000011000000000000000000!
000000000000011000000000000000000!
000000000000011000000000000000000!
000000000000011000000000000000000!